00000000000000000000
01011111111111011110
01000001111111111010
01110001111111000010
01111100001111111110
01121111111111111110
01111111111111111110
01111100001111111110
01110111111111111110
01110110000111111110
01110111111111111110
01110111111111111110
01111111111111000110
01111111110011011110
00000000000000000000