13 31
###############################
#p  1  ** *  1 * 2 *  * * *   #
# # # #*# # #*#*# # # #*#*#*# #
#  x*  s  ***  *      * 2 * * #
# # # # # #*# # #*#*# # # # #*#
#  f    b  x **  *  *         #
# # # # # # # # # #*# #*# # # #
#*  *      *  * 1    *        #
# # # # #*# # # #*#*# # # # # #
#*    **  *       *           #
# #*# # # # # # #*# # # # # # #
#           *   *  *          #
###############################