15 31
$$$$$$$$$$$$$$$$$$$$$$$$$$$$$$$
$$$$$$$$$$$$$$$$$$$$$$$$$$$$$$$
###############################
#p     ** *    * 2 *  * * *   #
# # # #*# # #*#*# # # #*#*#*# #
#  x*  s  *** 1*      * 2 * * #
# # # # # #*# # #*#*# # # # #*#
#  f    b    **  *  *         #
# # # # # # # # # #*# #*# # # #
#*  *      *  * 1    *  2     #
# # # # #*# # # #*#*# # # # # #
#*    **  *  1    *           #
# #*# # # # # # #*# # # # # # #
#    4      *   *  *  3       #
###############################