13 31
###############################
#p     ** *  1 * 2 *  * * *   #
# # # #*# # #*#*# # # #*#*#*# #
#  x*  s  *** 1*      * 2 * * #
# # # # # #*# # #*#*# # # # #*#
#  f    b  x **  *  *         #
# # # # # # # # # #*# #*# # # #
#*  *      *  * 1    *  2     #
# # # # #*# # # #*#*# # # # # #
#*    **  *  1    *           #
# #*# # # # # # #*# # # # # # #
#           *   *  *          #
###############################