15 31
$$$$$$$$$$$$$$$$$$$$$$$$$$$$$$$
$$$$$$$$$$$$$$$$$$$$$$$$$$$$$$$
###############################
#p     ** *  1 * 2 *  * * *   #
# # # #*# # #*#*# # # #*#*#*# #
#  x*  s  *** 1*      * 2 * * #
# # # # # #*# # #*#*# # # # #*#
#  f    b    **  *  *      4  #
# # # # # # # # # #*# #*# # # #
#*  *      *  * 1    *  2     #
# # # # #*# # # #*#*# # # # # #
#*    **  *  1    *           #
# #*# # # # # # #*# # # # # # #
#           *   *  *         3#
###############################