15 31
$$$$$$$$$$$$$$$$$$$$$$$$$$$$$$$
$$$$$$$$$$$$$$$$$$$$$$$$$$$$$$$
###############################
#      ** *  1 * 2 *  * * *   #
# # # #*# # #*#*# # # #*#*#*# #
#  x*  s  ***  *      * 2 * * #
# # # # # #*# # #*#*# # # # #*#
#  f    b    **  *  *         #
# # # # # # # # # #*# #*# # # #
#*  *   3   *  * 1    *  2    #
# # # # #*# # # #*#*# # # # # #
#*    **  *  1    *           #
# #*# # # # # # #*# # # # # # #
#p          *   *  *          #
###############################