00000000000000000000
01111111111111111110
01110101010101010140
01111111111111111110
01010401010101010140
01111411111111111110
01010401010101010140
01111111111111111110
01010101010101010140
01111111111111111110
01010104010101010110
01111114111111111110
01010401010101010100
01111111111111111110
00000000000000000000